{
  "one":
    {
      "a": "α",
      "b": "β",
      "c": "/",
      "d": "δ",
      "e": "ε",
      "f": "φ",
      "g": "γ",
      "h": "η",
      "i": "ι",
      "j": "=",
      "k": "κ",
      "l": "λ",
      "m": "μ",
      "n": "ν",
      "o": "ο",
      "p": "π",
      "q": "<",
      "r": "ρ",
      "s": "σ",
      "t": "τ",
      "u": "υ",
      "v": "ϋ",
      "w": "ω",
      "x": "ξ",
      "y": "ψ",
      "z": "ζ",
      " ": ":"
    },
  "two":
    {
      "th":"θ",
      "ae": "æ"
    }
}